NO ./textures/bluestone.xpm

SO ./textures/colorstone.xpm

WE ./textures/eagle.xpm

EA ./textures/greystone.xpm

F 10,80,0

C 25,100,220

1111111111111111111111111
1111111111111111111111111
1000000000110000000000001
1000000000000000000000001
1000000000110000000000001
1000000000110000000000001
1000000000000000000000001
10000000001100W0000000001
1000000000110000000000001
1000000000000000000000001
1000000000110000000000001
1000000000000000000d 00001
1000000000110000000000001
1111111111111111111111111
