NO ./textures/bluestone.xpm

SO ./textures/colorstone.xpm

WE ./textures/eagle.xpm

EA ./textures/greystone.xpm

F 220,100,0

C 225,30,0

1111111111111111111111111
1111111111111111111111111
1000000000110000000000001
1000000000000000000000001
1000000000110000000000001
1000000000110000000000001
1000000000000000000000001
10N0000000110000000000001
1000000000110000000000001
1000000000000000000000001
1000000000110000000000001
1000000000000000000000001
1000000000110000000000001
1111111111111111111111111
