NO ./textures/bluestone.xpm

SO ./textures/colorstone.xpm

WE ./textures/eagle.xpm

EA ./textures/greystone.xpm

F 220,100,0

C 225,30,0


11111111111111111111111111111
11000000110101011100000010001
10000000000000001100000010001
10000000000000001101010010001
1100000000000000000000000001111111111111111111111111111111
1000000000000000000000000000000000000000000000110001000001
1000000000000000000000000000000000000000000000110000000001
10000000000000000000000000000000000000000000000000000000001
10000000000000000000000000000000000000000000000000000000001
10000000000000000000000000000000000N0000000000110000000001
100000000000000000000000000000000000000000000011000000001
100000000000000000000000000000000000000000000011000000001
100000000000000000000000000000000000000000000011000000001
100000000000000000000000000000000000000000000011000000001
100000000000000000000000000000000000000000000011000000001
100000000000000000000000000000000000000000000011000000001
100000000000000000000000000000000000000000000011000000001
100000000000000000000000000000000000000000000011000000001
100000000000000000000000000000000000000000000011000000001
10000000000000000000000000000000000000000000001100000000111
10000000000000000000000000000000000000000000001101001000001
11111111111111111111111111111111111111111111111111111111111
