NO ./textures/bluestone.xpm

SO ./textures/colorstone.xpm

WE ./textures/eagle.xpm

EA ./textures/greystone.xpm

F 220,100,0

C 225,30,0


11111111111111111111111111111
10000000000000000000000000001
10000000000000001100000010001
10000000000000001101010010001
1i00000000000000000000000000111111111111111111111111111111
100000000000000000000000000000000000000000000011000000001
100000000000000000000000000000000000000000000011000000001
100000000000000000000000000000000000000000000000000000001
100000000000000000000000000000000000000000000000000000001
10000000000000000000000000000000000S000000000011000000001
100000000000000000000000000000000000000000000011000000001
100000000000000000000000000000000000000000000011000000001
100000000000000000000000000000000000000000000011000000001
100000000000000000000000000000000000000000000011000000001
100000000000000000000000000000000000000000000011000000001
100000000000000000000000000000000000000000000011000000001
100000000000000000000000000000000000000000000011000000001
100000000000000000000000000000000000000000000011000000001
100000000000000000000000000000000000000000000011000000001
100000000000000000000000000000000000000000000011000000001
100000000000000000000000000000000000000000000011000000001
111111111111111111111111111111111111111111111111111111111
