
11111111111111111111
10000000000000000001
1000000000000000001
10000000N000000001
10000000000y00001
1000000000000001
111111111111111
